date,total_ca20,total_ca50,total_ca100,total_ca200,total_sum
2024-09-02,2564,1100,600,300,4564
2024-09-03,2720,1400,1150,0,5270
2024-09-04,1290,900,712,500,3402
2024-09-05,2835,250,450,150,3685
2024-09-06,3075,1200,350,100,4725
2024-09-09,2663,1740,400,0,4803
2024-09-10,4505,1450,950,0,6905
2024-09-11,3978,930,250,770,5928
2024-09-12,3000,1800,600,250,5650
2024-09-13,3610,1500,0,0,5110
