date,total_ca20,total_ca50,total_ca100,total_ca200,total_sum
2024-09-02,4199,1915,861,350,7325
2024-09-03,4490,1725,1390,100,7705
2024-09-04,2830,1420,1372,795,6417
2024-09-05,5055,1005,1250,285,7595
2024-09-06,4955,2600,603,155,8313
2024-09-09,4953,2175,1630,140,8898
2024-09-10,7050,2010,1305,310,10675
2024-09-11,6233,2410,730,770,10143
2024-09-12,4137,2610,2298,643,9688
2024-09-13,5426,2435,1135,40,9036
2024-09-14,745,280,410,0,1435
